SO ./maps/textures/test.xpm
NO ./maps/textures/test.xpm
EA ./maps/textures/hd.xpm
WE ./maps/textures/test.xpm

F 155,55,155
C 122,122,22

        11111111111111111111111111111111
        10000000001100000000000000000001
        11100000111000000000000011111111
        1001000000000000000000001
111111111011000000000000000000001
100000000011000001110111111111111
11110111111111011100000010001
111101111 11111011101010010001
11000000110101011100000010001
10000000000000001100000010001
10000000000000001101010010001
11000001110101011111011110W0111
11111111 11111111111111111111